NO n.xpm
SO s.xpm
WE w.xpm
EA e.xpm
C 123,123,123
F 70,70,70
1111111111111111111111111111111111111111111111111111111111111111111111111111111111111111111111111111
1111111111111100011111111111111111111111111111111111000000111111111111111111111111111111111111111111
1111111111111000001111111111100111111111111111111110000000111111111111111111111111111111111111111111
1111111111111000001111111111000000011111111111111110000000111001111111111111111100011111111111111111
1111111111111000000011111111000000000111111111111111000000110000111111111111111000001111111111100111
1111111111111100000001111111100000000011111111111111100001110000011111111111111000001111111111000011
1110001111111100000001111111110000000000111111000111110011111000001111111111111100011111111100000011
1100000111111000000000111111111000000000001110000011100011111110000111111111111111111111111000000111
1100000001111000000000111111111111100000000000000000000111111111000011111111111111111100110000001111
1110000000111000000000011111111111110000000000000000000011111111100011111111111111111000000010011111
1111000000111000000000011111111111110000000000000000000001111111100011111111111111111000000111111111
1110000000000000000000011111111111110000000000000000000001110001000011111111111111110000000111111111
1100000000000000000000111111111111111000000000000000000000100000000011111111111111110001101111111111
1100000000000000000000111111111111111000000000000011000001000000000000010011111111110001100111111111
1100000000000000000000011111111111000000000000000111100011100001000000000001111111110000000001111111
1100000000000000000000011111111110000000000000000111111111111111110000000000111111110000010000011111
1000000000000000000000011111111100000000000000000111111111111111111000000000111111110000111000001111
1000000000000000000100111111111100000000000000001111111111111111110000000000111111111001111100001111
1000000000000000001111111111111100110000000000111111111111111111110000000001111111111000111000000111
1000000000111000000111111111111100110000000111111111111111111111111000011001111111110000111000000001
1100000000111000000011111111111100000000001111111111111111111111111000011100000111110000111000000001
1100000000011100000001111111111110000000001111111111111111111111111100001000000011110000001000000001
1100000000011110011000111111100111000000001111111111111110001111111110000000000001111000000110000001
1000000000111110011000111111000010001110000100111111111100000111111111111110000000110000000110000001
1000000000111110000000000010000000001110000000011111111100000111111111111111000000000011000000000011
1000010000001100000000000000000000001100000000011110011110000011111111111111000000000011000000000001
1100111000000000000000000000000000000000000000111100001111000001111111111110000000000011100000000001
1100011110000000000000000000000000000000011111111100001111100001111111111100000000000001000000000001
1100011111000000000000000000000000000000011111111000011111110001111111100000000000000000000000000001
1000011110000000000000000000000000001100000011111000011111110001111111000000000000000000110000000001
1000011100000000000100000000000000001100000001111100011111111000110010000000000000000111111100000011
1000001000000000001110000000000000001100000000111110001111111000000001000000000000000111111100000011
1000000000000000000110000000000000000110000000000100000111111000000011100000000000000011111110000011
1000000000000000000000000000000010000111000000000000000111110000000011110000000000000011111110000011
1000000000000000000000000000000111000010000000000001100111100000000011111000000000000011111110000011
1000000000000100000000000000000010000000000000000001100111100000000111111100000000000111111110000011
1100001110001110000000000000000000000000000000000011000111000011111111111110000000011111111110000011
1100011110011110000111000000000000000000000000000111000000000111111111111111100000011111111110000011
1100111100111111001111100000000000010000000000000111000000001111111111111111111000000111111111000001
1110111000111111111111100000000001111000000000000111100000111111111111001111111100000011111111000001
1110011000111111111111000000000001111100000000000111110000111111100000000111111100000001111111000011
1110000001111111111110000000000011111100000000000111110000011111000000000111111110000000111111100011
1111000001111111111110000000000111111110000000000111111000011111000000000000111111000000011111110011
1111111000001111100100000000000111111111100000000001111100111111000000000000011110000000001111110001
1111111100000111000000110000001111111111100000000000111111111111000001000000001110000000000111100001
1111111110000111000000110000001111111111100000000000111111111111000011100000000111000000000000000001
1111111110000011000000000100011111111111000000000000011111111111000011110000000011100110000000000001
1111111110000000001110001111111111111110000000000000011111111110000001110000000001100111000011000001
1111111110000000011110000111111111111100000000000000011111111110000000110000000001100111111111110001
1111111110000000111110000011111111111000000000000000111111111111000000000000000000000111111111110001
11111111110000001111100000011111111110000000000000N0011111111111111000000000000000000111111111100001
1111111110000000111100000001111111111100000000000000000111111111111110000000000000001111111111100001
1111111110000001110000000001111111111110000000000000000011111111111111000000000000111111111111100001
1111111110000001100000000001111111111111000000000000000001111111111111000000000001111111111111100001
1111110000000001100001000011100111111111100001100000000001111111111111100000001111111111110001100001
1111100000000001100011100011000011111111000001111110000001111111111111110000011111111111100000000001
1111100000000000000001000111000011111111000001111110000000000111111111111000011111111111100000000001
1111110000000000000000000010000001111110000011111111000000000001111111110000000000111111110000000001
1111111100000000000000000000000001111100000001111111111100000000111111100000000000011111111100000001
1111111111100000000000000000000001111100000000011111111100000000011111000000000000001111111110000001
1111111111110001100000100000000001111100000000001111111110000000001111000000000000001111111111000001
1111111111110001110001110000000011111000000000001111111100000000001111100000000000001111111111000001
1111111111110001111111111000000011111000000000011111111100000000001111100000000000011111111111000001
1111111111100001111111111100000000011000000000111111111110000000001111000000000000011111111111000001
1110011111000001111111111110001000001100000000111111111110000000011111000000000000011000011111000001
1100001110000000000111111111111100001110000000011111001000000001111111000000000000000000001111000001
1100000000000000000011111111111100000111000000001110000000000011111111100000000011000000001111000011
1100000000000000000011111111111100000011110000000110000001111111111111110000000011100000001111100111
1110000000000000000011111111111110000001111000000000000001111111111111110000000011100000011111111111
1111000000000000000011111111111111000000111100000000000000111111111111100001100000001100111111111111
1111100111000000000011111111111111000000011100000000000000011111111111000001110000011111111111111111
1111110111100000000000111111111111000110011000000000000000011111111110000000111001111111111111111111
1111110011100000000000011111001111000110011000000000000000111111111110000000111111111111111111111111
1111110001000000000000011100000011000000011100000000000001110011111111000000111111111111111111111111
1111110000000000000000111000000000000000001111100000000000100001111111100000111111111111111111111111
1111111000000000000011111000000000000000000111100000000000000001111111111001111111111111111111111111
1111111110000000000011111100000100000000000011110000000000000011111000111111111111111100011111111111
1111111110000000000000111110001110011000000001111100000000000011110000011111111111111000001111111111
1111111110000000000000011110001111111100000001111100000110000011110000001111111111111000001111111111
1111111111000000000000011111000011111000000001111100000110000011110000000111111100011000011111111111
1111111110000000000000011111100000110000000001111100000000100000000000000011111000000000111111111111
1111111110000000011000001111100000000000000011111000000001110000000000100001110000000001111111111111
1111111000000000111111001111110000000000000011111000000000110000000011110001100000011001111110001111
1111110000000000011111001111110000000000000001111100000000001000000011111100000001111000111100000111
1111110000000000011111001111110000000000000000011111000000001111100011111110000001100000111100000111
1111110000011000011111001111111000000000000000001111110000001111100001111110000000000000111110001111
1100000000011000001111100111111000000000000000000111110000011111110000011110000000000000011100011111
1000000000011000001111100011110000000000000000000011100000011111110000001110000000110000001100111111
1000000000111100001111100001100000001100000000000011001100011111110000000110000001110000001100011111
1100000111111100000000000000000000011100000000000000001110001111110000000000000011111000011100001111
1100001111111100000000000000000000111000000000000000001111001111100000000000000111111100011000001111
1110011111111100000000000000000001110000000000000000001111101111000000001100000111111100000000011111
1111111111111100000000000000000001100000000000000000011111100110000110011110001111111100000000001111
1111111111111110000000000000000000000000011000000000001111000110000111111111111111111100000000000001
1111111111111111000000000000000000000000111100000000000000000000001111111111111111111000000000000001
1111111111111111000011000000000000000000111000000000000000000000001111111111111111110001100000000001
1111111111111111100011000000000000110000110000000000000000000000001111111111111111100001110000000001
1111111111111111111000000000000111111000000000000000000110000110011111111111111111100001111000001111
1111111111111111111100000000001111111000000000000000000111001111111111111111111111100001111111111111
1111111111111111111111111111111111111111111111111111111111111111111111111111111111111111111111111111
