NO n.xpm
SO s.xpm
WE w.xpm
EA e.xpm

C 12,12,12
F 21,21,21
1111111111
1N11111111
1011111111
1011111111
1011110001
1011110001
1011110001
1011110001
1000000001
1111111111
