NO ./pngs/sillycat1.png
SO ./pngs/sillycat2.png
WE ./pngs/sillycat3.png
EA ./pngs/sillycat4.png
C 190,190,190
F 100,100,100
1111111111111111111111111111111111111111111111111111111111111111111111111111111111111111111111111111
1111111111111111111111111111111111111111111111111111111111111111111111111111111111100001001111111111
1111111111111100111111111111111111111111111110010011111111111111111111111111111111000000000111111111
1111111000111000011111111111111111111111111100000001111111111111111111111111111111000000000011111111
1111110000011000011111111111111111111111111100000001111111111111111111111111111110000000000001111111
1111100000000000001111111111111111111111111000000001111111111111111111111111111110000011000000111111
1111100000000000001111111111111111100111110000000000111111111110011111111111111110000111000000001111
1111000000000000001111111111111110000011110000000000011111111100001111001111111100001111100000000111
1111000000110000011111111111110000000011111000000000011111111000000110000111111100011111100000000111
1111000000110000111111111111100000000001111110000000011111111000000000000111111100011110000000001111
1111000000000000111100011111100000111001111110000000000111111000000000000111001000011100000000011111
1111000000000000111000001111110001111000111111000000000011111100000000000000000000011100000110001111
1111100000000001111000001111111111110000111111110000000011111110001110000000000000111100000110000001
1111000000000001111100001111111111110000011111111000000111111110001110000000000000011100000000000001
1110000000000000111100011111111111110000001111111110000011100000001111000000000000011100000000000001
1110000000000000000000111111111111111000001111111110000001000000000111100000000000011100000000000001
1111000000000000000000111111111111111100000110000100000010000000000011110000000000111110000000000001
1111000000000000000000111111111110011100000000000000011110000000000011111000100001111111110000001111
1111100000000000000000011111111100001110000000000000111100000000000011111111111111111111111000011111
1111100000000000000000001111110000000100000000000000011000000000000001111111111111111111111110001111
1111000000010000000000001111100000000000000000000000000000000000000001111111111111001111111110001111
1110000000111000000000001110000000000000000000000000000000000000000001111111111110000100111110000001
1110001001111100000100000000000000000000000000000000000000000000000000111111111110000000011110000001
1100011111111100001110000000000000000000000000000000000000000001100000111111111110000000001111000001
1100001111111100000110000000000000000000000000000000000000000001111000001111111100000000001111000001
1000001111111100000000000000000000000000000000000000000000000000111000000111111000000000000110000001
1000001111111100000011001100000000000000000000000000000000000000110000000111111000000000000000000001
1000000011111100000111111111100000000000000000000000000000000000110011000111111100000000000000000011
1000000001111110000011111111100001100000000000000000000000000000001111000011111110000000000000001111
1110000000011110000001111111000011100000001100000110011000000000001110000011111100000000000000001111
1111000000001110000000111111000111110011111110011111111100000000001110000011111100000000001100000111
1111100010001111000000001110000111111111111111111111111100000000001111000011111100000000001100000111
1111111111001111111100000100000111111111111111111111110000000111001111000000111110000000000000000111
1111111110000011111111000000001111111111111111111110000000001111000111100000011111111000000000001111
1111111000000001111111000000001111111111111111111100000000000111000011000000011111111100000001111111
1111110000000001111111100000000000111111111111111100000000000000000000000000011111111110000001111111
1111100011000001111111110000000000011111111111111100000000000000000000000000111111111111110000111111
1111000111100011111111110000000000011111111111111110000000000000011001000001111111111111110000111111
1111000011111111111111100000000000111111111111111111000000011000111111100011111111111111111001111111
1111000011111111111111000010000000011111111111111111100000011111111111100111111111111111111111111111
1111100011111111111111000111000000001111111111111111000000111111111111100111111111111100011111111111
1111110001111111111110001111110000000111111111111111000000011111111001100111111111111000001111111111
1111110001111111111100001111111000000011111111111111100000001111110000001111111111111000001111111111
1111100001111111111100001111111100000011111100111111111110000111110000011111111111111000001111111111
1111000000001111111100000111111100000000000000011111111111000111111000111111111110010000000011111111
1110000000000111111110000111111100000000000000001111111111100011111000111111111100000000000001111111
1100000000000011111110001111111100000000000000001111111111110001110000010011111000000000000000110001
1000000000000001111110000111111100000000000000000111111111110000110000000001111000000000000000000001
1000000000000001111110000111111000000000000000000000111111100000000000000000110000000000000000000001
1100000000000000011100001111111000000000000000000000011111100000000000000000100000000000000000000001
11000000000000000011000011111111000000000000000000N0001111100000000000000001000000000000000000000001
1100000000000000000000000111111110000000000001100000000111100000000110000111000000000000000000000001
1000000000000000000000000011111110000000000001110000000111110000000110000110000000000000000000000001
1000000000000000000000000011111111000000011000111000000111110000000000000000000000001100000000000001
1000000000000000000110000111111111000000011000111000001111110000100000000000000000001100000000000001
1000000110000000000110000011111000000000011101111100001111111001110000000000000000000000000000000001
1000001110000000001110000000110000000000011011111100000111111111110000000000000000000000000000000001
1111001100000001111110000000000000000000000001111000000011111111000000000000000000000000000000000001
1111100000000001111110000000000000000000000001110000000011111110000000000000000000000000000000000001
1111000000000000111111000000000000000000000001110000000001111100000000000010000000000000001000000001
1111000000000000011111000000000000000000000000100000000000111100000000000111000000000000011100000001
1110000000000000011111000000000000000000000000000000000000011000000000111111000110000000011110000011
1100001100010000111110000000000011000000000000000000000000001000110001111110001111000000000110000011
1100001100111111111110000000000011000110000000000000000000000111111111111100011111100000000000000011
1100000000111111111110000000000000001111000000000000000000001111111111111000111111100000000000000001
1110000000111111111111000000000000011110000000000000000000001111111111111000111111100000000000000001
1100000000011111111111100000000000111110000000000000000000000111111111110000011111110000110000000001
1100000000001111111111110000000000011110000000000000000000000111111111100000011111111111111110000001
1100000010000111111111111000000000011100000000000011111100000111111111100000001111111111111111000001
1100000111100011111111111000000000011000000000001111111110001111111111100000001111111111111111100001
1100000111110001111111100000000000000000000000001111111111111111111111100000001111111111111111100001
1000000011110000110011000000000000000000000000000111111111111111111111100000001111111111111111000001
1000000000110000000000000000000000000000000000000011100011111111111111100000001111111111111111000011
1000000000011000000000000000000000000000000000000011000001111111111111110000000000111111111111100111
1100000000011100000000000000011110011000000000000011000000111111111111100000000000011111111111111111
1111100100001000000000000000011111111000000000000111000000011111111111100000100000011111111111111111
1111111110000000000000000000111111100000000000000011100000011111111111100001110000011111111111111111
1111111110000000000000000000011111000001100000000001100000011111111111100000111000011111111111111111
1111111110000000000000000000001111000111110000000000000000000111111111000000111000111111111111111111
1111111110000000000000000000000111000111111110000000000000000011111111000000000011111001111111111111
1111111110000000000011000000000111000111111110000000000000000001111111000000000111110000111111111111
1111111100011000000011000110000111000111111111000000000000110000011111100000000011110000011111111111
1111111000011100000000000111000111000011111111000000000000111000001111100000000000111000011111100111
1111111000001100000000000111000111000011111110000000000000011100001111100000000000011100111111000011
1111111100001100000000000110000111100111111100000000000000001110000111110000000000001111111111000001
1111111100001100000000000110000111111111111000000000000000000100000111110000000000001111111111100001
1111110000011100000000000011001111111111111000000000000000001000001111110000000000001111111111110001
1111100000011110000000000011111111111111111000011000000000011100011100100000011000001111111111111001
1111100000011110000011100001111111111111111100011000000000011111100000000001111000011111111111111111
1111110000000110000011100001111111111111111100111100000000111111100000000011111100001111111111111111
1111110000000000000011100001111110011111111100111100001111111111000000000001111000000111111001111111
1111111011000000000011100001111100001111111000011000011111111111000000000001111000000111110000111111
1111110011100000000001100000111100000111111000000000011111111110000000000000000000000111110000011111
1111000001100000000000011000111110000011111100000000111111111110000000000000000000000111111000001111
1110000000000000000000011001111111100001111100000000111111111110000000000000000000000000011000001111
1110000000000000000000000011111111110001111100000000111111111111000000000000000000000000000000011111
1111000000000000000000000001111111111001111110000001111111111111100000000000011000000000000000011111
1111100001000000000000000001111111111000000110000011111111111111111000000000111100000000000000011111
1111110011100000000000000011111111111000000000000111111111111111111000000000111110000000000000111111
1111111111111111111111111111111111111111111111111111111111111111111111111111111111111111111111111111
