textures:
1 ./pngs/pikmin.png
2 ./pngs/pikmin1.png
3 ./pngs/pikmin2.png

wmap:
1111111
1000001
1000001
1000001
1000001
1000S01
1111111

tmap:
1213211
1000002
3000003
2000002
1000001
2000003
1123123

fmap:
1231231
1321321
1132321
1231211
1311321
1321311
1111111

rmap:
1122331
1313221
1331121
1321311
1122311
1321321
1111111