
NO ./pngs/sillycat1.png
SO ./pngs/sillycat2.png
WE ./pngs/sillycat3.png

F 100,100,100
EA ./pngs/sillycat4.png
C 190,190,190

11111111111111
11111111000001
11111111000001
11111100000001
1111110N010001
11111100000001
11111110000111
11111110111111
1111111010001111
11111110101011
11111110100011
10000000000001
11111111111111
1