SO     		./pngs/sillycat2.png        
WE ./pngs/sillycat3.png	
EA ./pngs/sillycat4.png
NO ./pngs/sillycat1.png

F 100,100,100
C 190,190,190

11111111111111
11111111000001
11111111000001
11111100000001
11111101010001
11111100000001
111111100011111
11111110111111
1111111010001111
11111110101011
11111110100011
1000000N000001
11111111111111
1