NO txt.png
SO txt.png
WE txt.png
EA txt.png
C 69,69,69
F 69,69,69
111111111111111111111111111111111111111111111111111
1N1111111111111100001111111001111111111111111110001
100111111111111100001111100000111111111111111100001
100000111111111110011111000000111111000111111100001
110000011111111111111110000001111110000000111100001
111100001100111111111110000111111110000000011000011
111100000000011111111110001111111110000000011001111
111100000000001111111110001111111110011100000011111
111110000000001111111110001111111100011100000111111
111110000000001111111110001111111000011110000111111
111110000000011100111111000111110000011110000011111
111111000000111000011110000111110000011110000001111
111111111000111000001110000111100000011110000001111
111111111000000000001100001111000000111110000000111
111111110000000000001100001111000001111110000000011
111111000000110000011100000111000000111110000000011
111110000000110000111110000111100000111110000000011
111110000000110001111111100011100000111110000000011
111110000000110011111111100011100000011111000000001
111110000000000001111111000111100000000111000000001
111100000000000000111111000011100000000011000000001
111000000000011100011111000001100000000001000000001
111000000000111110000010000000000001100010000000011
111100000001111110000000000000000001111111000000001
111110000011111111000000000000000011111111100000001
111111000011111111000000000000000111111111110000001
111111000001111110000000000000000011111111111000011
111000000001111110000000000000000011111111111111111
110000000000011110000001100000000011111111111111111
100000000000001110000011110000000111111111111111111
100000000000000000000111100000000111111111111111111
100000000000000000000111100000000011110011111111111
100000000000000000000011100000000001100001111111111
100000000000000000000011100000000000000000111111111
110000000000000000000011000000010000000000011111111
110000000000000001100111000000111000000000011111111
110000000000000001111111000000011100000000011111111
111000000000000000011111100000001111110000001111111
111000000000000000001111110000000111111000000111111
111100000000000000001100110000000111111000000011111
111111100110000000000000000000000111111000000011111
111111111110000000000000010000000011111100000001111
111111111000000000000000111000000011111100000000111
111111110000000000000000011111100111111110000000011
111111110000000000000000011111111111111111000000001
111111110000000000111100011111111111111111000000001
111111110000000001111110111111111111111111000000001
111111111000000001111111111111111111111111100000001
111111111110000000101111111111111111111111000000001
111111111111000000001111111111111111111111000000011
111111111111111111111111111111111111111111111111111
