textures:
1 ./pngs/ws/wsW1.png
2 ./pngs/floor_hex.png
3 ./pngs/ws/wsW3.png
4 ./pngs/ws/wsW4.png
5 ./pngs/ws/wsW5.png
6 ./pngs/ws/wsW6.png
a ./pngs/ws/wsRF1.png
b ./pngs/ws/wsRF2.png
c ./pngs/ws/wsRF3.png
d ./pngs/ws/wsRF4.png
e ./pngs/ws/wsRF5.png
f ./pngs/ws/wsRF6.png

wmap:
111111111111111111111111111111111111       111111111
100000000000000000000000000000000001       1111111001  E1
100000000001100000000001100000000001       111111111
100000000001100000000001100000000001
100000000001100000000001100000000001
100000000001100000200001100000000001
100000000001100022020001100000000001
100000000001100000002001100000000001
100000000001100000000001100000000001
100000000001100000000001100000000001
100000000000000000000000000000000001
101111111100001111111100001111111101
101111111100001111111100001111111101
100000000000000000000000000000000001
100000000001100000000001100000000001
100000000001100000000001100000000001
100000000001100000000001100000000001
100000000001100000000001100000000001
100000000001100000000001100000000001
100000000001100000000001100000000001
100000000001100000000001100000000001
100000000001100000000001100000000001
100000000000000000000000000000000001
111111111111111111111111111111111111
1    1
tmap:
111111111111222222222222333333333331       111111111
100000000000000000000000000000000003       111111101     
100000000001200000000002300000000003       111111111
100000000001200000000002300000000003
100000000001200000000002300000000003
100000000001200000200002300000000003
100000000001200022020002300000000003
100000000001200000002002300000000003
100000000001200000000002300000000003
100000000001200000000002300000000003
100000000000000000000000000000000003
101111111100002222222200003333333303
404444444400005555055500006666666606
400000000000000000000000000000000006
400000000004200000000002300000000006
400000000004200000000002300000000006
400000000004200000000002300000000006
400000000004200000000002300000000006
400000000004200000000002300000000006
400000000004200000000002300000000006
400000000004200000000002300000000006
400000000004200000000002300000000006
400000000000000000000000000000000006
144444444444555555555555666666666661
a    1
fmap:
aaaaaaaaaaaabbbbbbbbbbbbcccccccccccc       111111111
aaaaaaaaaaaabbbbbbbbbbbbcccccccccccc       111111111     
aaaaaaaaaaaabbbbbbbbbbbbcccccccccccc       111111111
aaaaaaaaaaaabbbbbbbbbbbbcccccccccccc
aaaaaaaaaaaabbbbbbbbbbbbcccccccccccc
aaaaaaaaaaaabbbbbbbbbbbbcccccccccccc
aaaaaaaaaaaabbbbbbbbbbbbcccccccccccc
aaaaaaaaaaaabbbbbbbbbbbbcccccccccccc
aaaaaaaaaaaabbbbbbbbbbbbcccccccccccc
aaaaaaaaaaaabbbbbbbbbbbbcccccccccccc
aaaaaaaaaaaabbbbbbbbbbbbcccccccccccc
aaaaaaaaaaaabbbbbbbbbbbbcccccccccccc
ddddddddddddeeeeeeeeeeeeffffffffffff
ddddddddddddeeeeeeeeeeeeffffffffffff
ddddddddddddeeeeeeeeeeeeffffffffffff
ddddddddddddeeeeeeeeeeeeffffffffffff
ddddddddddddeeeeeeeeeeeeffffffffffff
ddddddddddddeeeeeeeeeeeeffffffffffff
ddddddddddddeeeeeeeeeeeeffffffffffff
ddddddddddddeeeeeeeeeeeeffffffffffff
ddddddddddddeeeeeeeeeeeeffffffffffff
ddddddddddddeeeeeeeeeeeeffffffffffff
ddddddddddddeeeeeeeeeeeeffffffffffff
ddddddddddddeeeeeeeeeeeeffffffffffff
     1
rmap:
aaaaaaaaaaaabbbbbbbbbbbbcccccccccccc       111111111
aaaaaaaaaaaabbbbbbbbbbbbcccccccccccc       111111111     
aaaaaaaaaaaabbbbbbbbbbbbcccccccccccc       111111111
aaaaaaaaaaaabbbbbbbbbbbbcccccccccccc
aaaaaaaaaaaabbbbbbbbbbbbcccccccccccc
aaaaaaaaaaaabbbbbbbbbbbbcccccccccccc
aaaaaaaaaaaabbbbbbbbbbbbcccccccccccc
aaaaaaaaaaaabbbbbbbbbbbbcccccccccccc
aaaaaaaaaaaabbbbbbbbbbbbcccccccccccc
aaaaaaaaaaaabbbbbbbbbbbbcccccccccccc
aaaaaaaaaaaabbbbbbbbbbbbcccccccccccc
aaaaaaaaaaaabbbbbbbbbbbbcccccccccccc
ddddddddddddeeeeeeeeeeeeffffffffffff
ddddddddddddeeeeeeeeeeeeffffffffffff
ddddddddddddeeeeeeeeeeeeffffffffffff
ddddddddddddeeeeeeeeeeeeffffffffffff
ddddddddddddeeeeeeeeeeeeffffffffffff
ddddddddddddeeeeeeeeeeeeffffffffffff
ddddddddddddeeeeeeeeeeeeffffffffffff
ddddddddddddeeeeeeeeeeeeffffffffffff
ddddddddddddeeeeeeeeeeeeffffffffffff
ddddddddddddeeeeeeeeeeeeffffffffffff
ddddddddddddeeeeeeeeeeeeffffffffffff
ddddddddddddeeeeeeeeeeeeffffffffffff
     1