NO n.xpm
SO s.xpm
WE w.xpm
EA e.xpm
C 12,12,12
F 21,21,21
1111111111111111111111111111111111111111111111111111111111111111111111111111111111111111111111111111
1111100011111111111111111111111111111111111111111111111111111111111110000000001111111000111111111111
1111000001111111111111111111111111111111111111111111111111111111111100000000001111110000011111111111
1111000001111111111111100111111111111111111111110011111111111111111000001100001111110000011111111111
1111000001111111111111000001111111001111111111100001111111111111110000001110000111111000001111111111
1111000011100111111111000000111110000111111111100000000111111111110000000110000111111000001111111111
1111100111000011111111000000111110000111111111110000000011111111110000000001111111111100001111111111
1111111111000011111111000000111111001111111111111000000011111111110000000001111111111110011111111111
1111111111000001111110000000111111111111100111111000000011111111110000000001111111111111111111111111
1111111110000000011110000000111111111111000011111000000001111111000000000000111111111111111111111111
1111111110000000001100000000011111111111000001111000000000000110000000000000111111111111111111111111
1111111111000000000000000000001111001111100000111000000000000000000000000000111111111111111111111111
1111111110000000000000000000000110000111111000111000000000000000000000000001111111111100111111111111
1111111100000000000000000000000110000111111000000000000000000000000000001111111111111000001111111111
1111111100000000001000000000001111000001110000000000000000000000000000001111111111111000000111111111
1100110000000000011100000000000111100000000000000000000000000000000000011111111111110000000111111111
1000000011000000011100011000000111100000000000000000000000000000000000111111111111000000001111111111
1000001111000000000000111100000111000000000000000000000000000110000001111111111110000000001111111111
1000001111000000000000011111000110000000000000000000000000000111100001111111111110000000011111111111
1100000011000000000000011111100000000000000000000000000000001111110000111111111100000000001111111111
1110000000000000000000011111000000000000000000000000000000001111110000111111111000000000001111111111
1111000000000000000000111100000000000000100000000000000000001111110001111111111000000000011100111111
1110000000111110000000011000000000000001110000000000000000000100111001111111110000000000001000011111
1110001100111111000000000000000000000001100000000000000000000000011100001111110000000000000000001111
1110011100011111000000000000000000000001100000000000000000000000011110000111111000000000000000000011
1111001100011111100000110000000000000001100000000000001100000100111111000111111100000000000000000001
1111001110111111100000110000000000000001110000000000001100001111111111100011111110000000000000000001
1111101100111111100000000000001100000000111000000000000000001111111111100011111100000000000000000001
1111100000111111100000000001111100000000111110000011000000011111111111110011111100000110000000000011
1111000000111111000000001111111110000001111111000111111111111111111111100000011100011110000000000111
1110000001111110000000001111111111000011111111001111111111111111111111100000001110011111000000011111
1100000001111100000000011111111111000001111111100111111111111111111111110000001110000111100000011111
1100000000111100000000111111111111000001111111100011111111111111111111111100011110000011110000011111
1100000000111100000001111111111100000000111111110111111111111111111111111110111111000001111000111111
1110000000111000000000111111111000000000000111111111111111111111111111111101111111100001111100110001
1111000001110000000000011111111000000111100011111111111111111111111111111000111111110011111000000001
1111100011100000000000011111110000000111100011111111111111111111111111111000111111110011111000000001
1111111111100000000000111111110000000111100001111111111111111111111111110000000011110001111000000001
1111111111000000000001111111100000001111000000111111111111111111111111100000000001110001111000000001
1111111111000000000001111111000000011111000000111111111001111111111111000000100000111000111000000001
1111111110000000000000111111000000011111100001111111110000111111111111000001110000010000011000000001
1111111100000000000000111110000000011111100001111111100000011111111100000011110000000000011000110011
1111111000000000000000111100000000011111000000111111100000001111111000000111100000000100011001111111
1111111000000000000000000000000000001110000000011111100000000111110000000011000000001110000001111111
1111111100000000000100000000000000000110000000011110000000000111100000000000000000000110000001111111
1111111100000000001111110000000000000110000000111100000000000011000000000000000000000110000001111111
1111111100000000000111110000000000000111000001111100000000000011000000000000000011001110000001111111
1111001000001100000111100000000000000011111111111000000000000011000000000000000011111110000001100001
1110000000001100000011000000000000000001111111110000000000000011000000000100000111111110000000000001
1110000000000000000000000000000000000001111111110000000000000011100000001110000111111100000000000001
11000000000000000000000001111100000000111111111110N0000000000011111000000110000011111100000000000001
1000001111000000000001001111111000000001111111111110000000000111111000000000000011111110000000000011
1000001111100000000011111111111000000000111111111111000000001111111000000000000001111111000000000001
1000001111110000000011111111110000000000111111111111100000000110011000000000000001111111000000000001
1000000111100000011100110011100000000001111111111111110000000000000000000000000011111110000000000011
1000000010000000011000000001100000000001111111111111110000000000000000000000000001111110000000011111
1100000000000110000000010000000000000001111111111111110000000000000000000000000000110000000000011111
1100000000111111000011111000000000000000111111111111111000000000000000000000000000000000000000000111
1100000111111110000111111100000000000000011111111111111000000000000000000000000000000000000000000011
1100000111111110001111111000000000000000011111111001111100000000000000000000000000000000000000000001
1000000000011110001111111000000000110000001111110000111100000000000000000000000000000011000000000001
1000000000001111000111111100000000111000000111110000111100000000000000000001110000000011000011000001
1100000000001111000001111100000000111000000011110000111100000000000000000011111100000000000111000001
1100000010011111000000111000000001111000000011110000111110000000000000000011111110000000000010001111
1000000111111111000000110000000001110000000001110000111111110000000000000011111110000000000000001111
1000000111111110000001110000000001100000000000110000111111111000000000000111111110000000000000001111
1100001111111110000111110000000011100000000000000000111111111000000000001111111110000000000000000111
1110001111111110001111111000000011110000000000000000011111110000000000011110000000000000000000000011
1111111111111111000111111000000011110000000000000000001100110000000001111100000000000000000000000001
1111111111111111100011111000000011100000000000000010000000011000000111111100000110000000000000000001
1111111111111111100001111100000000000000000000000111000000011000000111111100000110000000000000000001
1111111111111110000001111110000000000001100000000010000000111100000111110000000000000000000000000001
1111111111110000000001111100000000000001100000000000000001111110011010000000000000000000000000000001
1111111111100000000001111100000000000011100000000000000001111111110000000000000000000000000000000001
1111111111000000000001111000000011000111100000000000000011111111100000000100000111000000000000000011
1111111110000000000001111000000111000111000100000000000001111111100000001111111111000000000000000011
1111100000000000000000111000000110000010001110000000000000111111100000011111111110000000000000000011
1111000000001000001100111100000000000000000110000000000100011111110000111111111100000000000000000011
1111000000011100001100011110000000000000000000000000001110011111110001111111111000000000000000000011
1111000000011100001100001110000000000000000000000000000100011111100011111100110000110000001000000011
1111100000011110000000001110000000000000000000000000000000001111100001111000000001111100111100000011
1111110000111110000000011100000000000000000000000000111000000111100001111000000001111111111100000111
1111110000111111000000001100000000000011100000000011111100000111100001111100000001111111111100000111
1111111000111111100000000000000000000011100000000011111100000111110011111110000001111111111110001111
1111110000111111110000100000000010000011000000000111111110001111111111111111000001111111111110001111
1111100000010011111111111111000111000111000000001111111110000111111111111111100001111111111110000111
1111100000000001111111111111000011100011100000001111111111000001111111111111000000011100011110000011
1111110000000000000111111110000011000011000000000111111111100000011111111110000000000000001111000001
1111111000000000000011111110000000000000000000000111111111100000001110011110000001100000001111000001
1001111000000000100001111100000000000000000000000111111111100000000100001110000111110000011110000001
1000111100000011110001111000000000000000000000000111111111000000000000001110000111111000011110000001
1000011110000011100001111000000000000000000000000111111110000000000000000000000111111000011110000001
1000000110000011000001110000000000000000000000001111110000000000000011000000001111111000000000000001
1000000000000000000000110000000000000000000000111111100000000000000111000000011111111000000000000001
1000000000000000000000000011000000000000000000111111100000000000000111100000111111000000000000001001
1000000000000000000000000111110000000000000001111111110000001111100111111000111110000000000000011101
1000000000100000000001111111110000000000000001111111111000001111111111111100011000000000000000111101
1000000001110000000011111111110000000110000011111111111000001111111111111100000000000000000000011001
1000000111111000000111111111111000001110000111111111111000011111111111111100000000000000000000000001
1111111111111111111111111111111111111111111111111111111111111111111111111111111111111111111111111111
