NO n.xpm
SO s.xpm
WE w.xpm
EA e.xpm
C 203,139,188
F 240,192,217
1111111111111111111111111111111111111111111111111111111111111111111111111111111111111111111111111111
1111111111111111111111111111111111111111111111110000111111111111111111111111111100000111110001111111
1111111111111111111111111111111111111111111111100000011111111111111001111111111100000111100000111111
1111111111111111111111111111111111111111111111100000001111111111110000111111111110001111000000011111
1111111111111111111001111111111111100111111111110000000111111111100000011111111100000111000000011111
1111111110011111110000111111111111000011111111111000000111111111100000001111111100000011000000011111
1111111100001111110000001111111111000000111111111000000111111111110000001111111100000000000000001111
1111111100001111110000000111111111100000011111111000000011111111111100001111111100000000000000000111
1111111110011111111000000011111111110000001111111000000001111001111100000111111000000000000000000111
1111111111111111111000000011111111111100001111111000000001110000111000000011110000000000000000001111
1111111111111111111100000001111111111110000000011000000001110000010000000001110000000000000000001111
1111111111111111111000000001111111111111000000001000000000111000000000000000111000111110000000000011
1111111111111111111000000000111111111111110000001100000000111111000001100000001111111111000000000001
1111111111111000110000000000111111111111110000011111000000111111000011111100000111111111100000000001
1111111111110000000000000000111111111111111000111111100000111111000011111100000111111111100000110011
1111111111110000000010000000011111111111111111111111000001111110000001111100000111111111000001111111
1111111111110000000111000000001111111111111111111111000001111110000000010000000111111110000011111111
1111111111100000000011000000001111111111100110011111000000011111000000000000000011111110000011111111
1111111111000000000000000000011111111111100110101111100000001111100000000000000001111111000011111111
1111111111000000000000000000111111110001101110011111110000001111100000000000000000110011000001111111
1111111111100000000000000000111110000000111111111111111100011111110000000000000000000000000001111111
1111111111100000000000000000011100000000111110111111111110111111111111110000000000000000000001111111
1111111110000000000000000000011000000000111110111111111100111111111111110000000000000000000011111111
1111111100000000000000000000111000000000011110111111111100001111111111111000000000000000000011111111
1111111000000000000000000000111000000000011111111111111100000111111111111111000000000000000001111111
1111000000000100000000000000011001100000111110011111111100000111111111111111000011000000000000110011
1110000000001110000000000000011101110000011110101111111100000111111111111111100011100000000000000001
1110000000000111000000000000001000110000011110011111111100000111111111111111110001000000000000000001
1100000000000111000000000000000000000000111111111111111100001111111111100111111000001110000000000001
1000000000000111000000000000000000000001111110111111111100000111111111000011111000011110000000000001
1000000000001110000000111000000000000001111110111111111110000111111111000001111100111111000000000001
1000000000001110000000111110000000000000111110110011111100000011111111000000111111111110000000000011
1000011000001110000000111111000000000000000011100001111100000000111111000000111111111110000000000011
1000011000001111000001111111000000000000000000000001111110000000011111100000000111111100000000000011
1000011000001110000011111111000000000000000000000000111110011000000111110000000011111000000000000111
1000011000001110001111111111100000000000000000000000111111011000000011111000000011111000000000000111
1000000000000110001100100011100000000000011110000000011111000000000001111100000001111000000000000111
1000000000000000000000000001000011000000011110000000001111000000000000111111110001111100000000001111
1000000000000000000000000000000011000000011111000000001111000000000000111111111001111100000000111111
1100000000000000000000000000000000000000011111111100011111000000000000000100111000111110000000111111
1111100000000000000000000000000000000000000011111111111111100000000000000000000000111110000000111111
1111110000000001100000000000000000000010000000011111111111000000000000000000000000111111000000001111
111111100000000111100000000000000000011100000000111111111100000000011N000000000001111111110000000111
1111111100000000011000110000000000000111111000001111111111100000000111100000000011111001110000000011
1111111110000000001100110000000000000111111110000111111111110000000001100000000001100000111001100011
1111111110000000001110000000000000000111111110000111111111111000000000001100000000000000010001100001
1111111110000000000100000000000000000011111100000111111111111000000000001110000000000000000000000001
1111111111000000000000000000000000000011111100000010011111110000000000000111000000000000000000011001
1111111111110000000001100001000000000001111000000000000011110001000001100011100000000000000000011001
1111111111111000000011100011110000000000000000000000000001110011100011100011110010000000000000000001
1111111111111100000011000011111000010000000000000011000001110001111111100111111111000000000000000001
1111111111111100000000000111111000111000000000000111000001110001111111011111111111100000000000000001
1111111111111110000000001111110000111100000000001111100001111011111110001111111111110000000000000001
1111111111111110000000000111110000011100000000001111110011111111111110000001111111111001111000000011
1111000001111100000011000111111000011100000000011111111111111111111111000000111111111111111000000111
1110000000110000000011100111111101100000000000111111111111111111111111000000011111111111111000000111
1110000000100000000001110000100011100000001111111111111111111111111111000000011111111111111000000011
1111000001000000000001110000000001001110011111111101111111111111111110000000011111001111111000000011
1111000011100000000010000001000000011111111111111101111111111111111100000000001110000111110000000111
1111000111100000000110000011111100011111111111111101111111111111111000000000000000000111110000001111
1111001111100000000110000001111100001111111111111010111111100011111000000000000000000111111000001111
1100000111000000000000000000111100000111111111111111111111000001000000000000000000001111111100011111
1000000111000000000000000000011100000111111111111111111111000000000000000000000000001111111111111111
1000001111000110000000000000001100001111111111000111100011100000000000000000000000001111111111111111
1100011100001110000000000000001100000111100010000011000001000000000000000000000000001111111111111111
1110011000011110000000000000000000000000000000000000000000000000000000000000000110011111111111111111
1111000000111111000001100000000000000000000000000000000000001100000000000000001111111111111110011111
1110000000011111100011110000000000000000000000000000000100001100000000000001111111111111111100000111
1110000000000111111111111000000000000001000000000000001110011110000000000001111111111111111100000011
1111001100000011111111111011000000000011100000000000011111111110000000110011111111111001111000000011
1111111100000001111111100011000000000111111100000000111111111110000001111111111110010000111000000111
1111110000000000011111000000000000000011111100000000111111111110000011111111111100000000011000000111
1111100000110000001110000000000000000001111000000000011111111111000001111111001000000000000000001111
1111100000111000001110000000000000011000011000000000011111111111000000011110000000000000000000011111
1111000000111100001110000000000000111100000000000000011111111111000000001100000000000000000000001111
1111000001111110000111000000000000011110000000000000111111111111100000000000000000000000000000001111
1111000000111100000011000000000000011110000000000000111111111111100000000000000000000000110000001111
1111100000111100000011000000000000111110000000000000111111111111110000000000000000000001110000001111
1111100000000000000111000000000001111110000000110001111111111111111000000000000000000011110000000111
1111110000000000001111100000000011111100000000111111111111111111111110000000000000000011110000000011
1111111110000000000111100000000001111000000000011111111111111111111110000000000010000001110000000011
1111111110000000000000000000000001111000000000001111110011111111111110000000111111000000000000000011
1111111110000000000000000000000001111000000000001111100001111111111000000000111110000000000000000001
1111111100000000000000000000000001111000000000001111000000111111110000000000111110000000000000000001
1111111000000110000000000011000011111000000000000011000000011111110000000001111111000000000000000001
1111111000000110000000000011111111111100000000000000000000011111111000000011111111000000000000000011
1111110000000000000000000111111111111111110000000000000000111111111000000111111111000000000001100111
1111110000000000000000011111111111111111110000000000000001111111111000111111111110000000000011111111
1111110000000000010000011111100111111111100000000000000011111111111100111111111110000000000011111111
1111111000000001111100001111000011111111100000000110000011111111111100000111111111000000000001111111
1111111100000011111110001110000001111111000000000110000001111111110000000011111111100000000001111111
1111111000000111111100000100000000001111000000000110000000111111100000000000111001100000110011111001
1111110000111111111100000000000000000111000000000000000000111000000000000000010000000000111111110001
1111110001111111111110000000000000000010000000000000000000010000000000000000000000000000011111110001
1111100001111111111111110000000001110000000110000000000000000000011000000000000000000000011111111001
1110000011111111111111110000000001111000001111000000000000000000011111100000000000000000011000011001
1100000111111111111111110000000000111000011111000000000000000000111111100000000000000000000000001101
1100001111111111111111111000000000111100111111000000000000000001111111100000000000000000000000000011
1000011111111111111111111100000000111111111111000000000000000111111111100000000000000000000000000011
1111111111111111111111111111111111111111111111111111111111111111111111111111111111111111111111111111
