textures:
1 ./pngs/sillycat1.png
2 ./pngs/sillycat2.png
3 ./pngs/sillycat3.png
4 ./pngs/sillycat4.png
5 ./pngs/floor_hex.png

wmap:
11111111111111
11111111000001
11111111000001
11111100000001
11111100010001
11111100000001
11111110000111
11111110111111
1111111010001111
11111110101011
11111110100011
1000S000000001
11111111111111

tmap:
11111111111111
11111111000001
11111111000001
11111100000001
11111100010001
11111100000001
11111110000111
11111110111111
1111111010001111
11111110101011
11144110100011
10000000000001
11222233333441

fmap:
55555555555555
55555555555555
55555555555555
55555555555555
55555555555555
55555555555555
55555555555555
55555555555555
5555555555555555
55555555555555
55555555555555
55555555555555
55555555555555

rmap:
55555555555555
55555555555555
55555555555555
55555555555555
55555555555555
55555555555555
55555555555555
55555555555555
5555555555555555
55555555555555
55555555555555
55555555555555
55555555555555